111111111111
10000001E001
100000000001
1          1

