1111111111111111111111111111111111111
1E00000000000000000000000000000000001
1000000000000000000000000000000000001
1000000000000000000000000000000000001
1000000000000000000000000000000000001
1000000000000000000000000000000000001
1000000000000000000000000000000000001
10000000000000000000000C0000000000001
1000000000000000000000C00000000000001
100000000000000000000C000000000000001
10000000000000000000C0000100000000001
1000000000000000000C00000000000000001
100000000000000000C0000000000000000C1
10000000000000000C0000000000000000C01
1000000000000000C0000000000000000C001
10000000000000000000000000000000C0001
1000000000000000000000000000000C00001
100000000000000000000000000000C000001
10000000000000000000000000000C0000001
1000000000000000000000000000C00000001
100000000000000000000000000C000000001
10000000000000000000000000C0000000001
1000000000000000000000000C00000000001
1000000000000000000000000C00000000001
1000000000000000000000000000000000001
1000000000000000000000000000000000001
10000000000000000000000000000000000P1
1111111111111111111111111111111111111
